//MAP CONVERTED BY dmm2tgm.py THIS HEADER COMMENT PREVENTS RECONVERSION, DO NOT REMOVE
"aA" = (
/turf/template_noop,
/area/template_noop)
"be" = (
/obj/structure/cable,
/obj/machinery/power/apc/auto_name/directional/south,
/obj/effect/mapping_helpers/apc/syndicate_access,
/turf/open/floor/iron/dark,
/area/ruin/interdyne_planetary_base/science)
"bs" = (
/obj/machinery/button/door{
	id = "lavalandsyndi_mistake";
	name = "Chemistry Blast Door Control";
	pixel_y = 26;
	req_access = list("syndicate")
	},
/obj/machinery/atmospherics/pipe/smart/manifold4w/cyan/visible,
/obj/effect/turf_decal/stripes/line{
	dir = 8
	},
/turf/open/floor/engine,
/area/ruin/interdyne_planetary_base/science)
"dO" = (
/obj/structure/sign/warning/explosives/alt/directional/west,
/obj/machinery/atmospherics/components/tank/nitrogen{
	dir = 4;
	initialize_directions = 4
	},
/obj/effect/turf_decal/stripes/line{
	dir = 5
	},
/turf/open/floor/iron/dark,
/area/ruin/interdyne_planetary_base/science)
"ef" = (
/obj/machinery/atmospherics/pipe/smart/manifold4w/supply/hidden/layer4,
/obj/machinery/atmospherics/pipe/smart/manifold4w/scrubbers/hidden/layer2,
/obj/structure/cable,
/turf/open/floor/iron/dark,
/area/ruin/interdyne_planetary_base/science)
"em" = (
/turf/closed/wall/mineral/plastitanium/nodiagonal,
/area/ruin/interdyne_planetary_base/science)
"eq" = (
/obj/machinery/door/airlock/engineering{
	name = "Supermatter"
	},
/obj/effect/mapping_helpers/airlock/access/all/syndicate/general,
/turf/open/floor/iron/dark,
/area/ruin/interdyne_planetary_base/science)
"eZ" = (
/obj/structure/table/reinforced,
/obj/item/paper_bin,
/obj/item/pen,
/turf/open/floor/iron/dark,
/area/ruin/interdyne_planetary_base/science)
"fY" = (
/obj/machinery/power/energy_accumulator/grounding_rod/anchored,
/obj/structure/cable,
/turf/open/floor/engine,
/area/ruin/interdyne_planetary_base/science)
"gJ" = (
/obj/structure/table/reinforced,
/obj/item/paper/crumpled{
	default_raw_text = "Explosive testing on site is STRICTLY forbidden, as this outpost's walls are lined with explosives intended for intentional self-destruct purposes that may be set off prematurely through careless experiments.";
	name = "Explosives Testing Warning";
	pixel_x = -6;
	pixel_y = 5
	},
/obj/item/clothing/glasses/meson{
	pixel_y = 8
	},
/obj/item/clothing/glasses/meson{
	pixel_y = 5
	},
/obj/item/clothing/glasses/material/mining{
	pixel_y = 2
	},
/obj/item/clothing/glasses/meson,
/turf/open/floor/iron/dark,
/area/ruin/interdyne_planetary_base/science)
"gX" = (
/obj/machinery/airalarm/directional/north,
/obj/item/stock_parts/matter_bin/bluespace,
/obj/item/stock_parts/matter_bin/bluespace,
/obj/item/stock_parts/matter_bin/bluespace,
/obj/item/stock_parts/matter_bin/bluespace,
/obj/item/stock_parts/matter_bin/bluespace,
/obj/item/stock_parts/matter_bin/bluespace,
/obj/item/stock_parts/micro_laser/quadultra,
/obj/item/stock_parts/micro_laser/quadultra,
/obj/item/stock_parts/micro_laser/quadultra,
/obj/item/stock_parts/micro_laser/quadultra,
/obj/item/stock_parts/micro_laser/quadultra,
/obj/item/stock_parts/micro_laser/quadultra,
/obj/item/stock_parts/servo/femto,
/obj/item/stock_parts/servo/femto,
/obj/item/stock_parts/servo/femto,
/obj/item/stock_parts/servo/femto,
/obj/item/stock_parts/servo/femto,
/obj/item/stock_parts/servo/femto,
/obj/structure/rack,
/obj/effect/mapping_helpers/airalarm/syndicate_access,
/turf/open/floor/iron/dark,
/area/ruin/interdyne_planetary_base/science)
"hJ" = (
/obj/machinery/atmospherics/pipe/smart/manifold4w/cyan/visible,
/turf/open/floor/catwalk_floor/iron_dark,
/area/ruin/interdyne_planetary_base/science)
"hK" = (
/obj/effect/spawner/structure/window/reinforced/plasma/plastitanium,
/obj/machinery/door/poddoor{
	id = "lavalandsyndi_mistake"
	},
/turf/open/floor/plating,
/area/ruin/interdyne_planetary_base/science)
"iF" = (
/obj/structure/window/reinforced/plasma/spawner/directional/south,
/obj/structure/window/reinforced/plasma/spawner/directional/west,
/obj/machinery/atmospherics/components/unary/vent_pump/on{
	dir = 8
	},
/turf/open/floor/engine,
/area/ruin/interdyne_planetary_base/science)
"iQ" = (
/obj/structure/sign/warning/explosives/alt/directional/south,
/obj/machinery/atmospherics/pipe/smart/manifold4w/cyan/visible,
/turf/open/floor/engine,
/area/ruin/interdyne_planetary_base/science)
"js" = (
/turf/open/floor/engine,
/area/ruin/interdyne_planetary_base/science)
"kw" = (
/obj/item/stack/sheet/plasmarglass,
/obj/structure/window/reinforced/plasma/spawner/directional/south,
/turf/open/floor/engine,
/area/ruin/interdyne_planetary_base/science)
"kE" = (
/turf/open/floor/iron/dark,
/area/ruin/interdyne_planetary_base/science)
"kP" = (
/obj/effect/turf_decal/stripes/line,
/obj/machinery/power/energy_accumulator/tesla_coil/anchored,
/obj/structure/cable,
/turf/open/floor/engine,
/area/ruin/interdyne_planetary_base/science)
"lR" = (
/obj/effect/turf_decal/stripes/line{
	dir = 6
	},
/obj/machinery/power/energy_accumulator/grounding_rod/anchored,
/obj/structure/cable,
/turf/open/floor/engine,
/area/ruin/interdyne_planetary_base/science)
"me" = (
/obj/machinery/atmospherics/pipe/smart/manifold4w/cyan/visible,
/turf/open/floor/engine,
/area/ruin/interdyne_planetary_base/science)
"ol" = (
/obj/machinery/firealarm/directional/east,
/turf/open/floor/iron/dark,
/area/ruin/interdyne_planetary_base/science)
"on" = (
/obj/machinery/door/firedoor,
/obj/machinery/atmospherics/pipe/smart/manifold4w/supply/hidden/layer4,
/obj/machinery/atmospherics/pipe/smart/manifold4w/scrubbers/hidden/layer2,
/obj/machinery/door/airlock/hatch{
	name = "Experimentation Lab"
	},
/obj/effect/mapping_helpers/airlock/access/all/syndicate/general,
/obj/structure/cable,
/obj/modular_map_connector,
/obj/effect/turf_decal/tile/neutral/fourcorners,
/turf/open/floor/iron/dark,
/area/ruin/interdyne_planetary_base/science)
"oo" = (
/obj/machinery/atmospherics/pipe/smart/manifold4w/scrubbers/visible,
/obj/machinery/power/energy_accumulator/tesla_coil/anchored,
/obj/structure/cable,
/turf/open/floor/engine,
/area/ruin/interdyne_planetary_base/science)
"qY" = (
/obj/machinery/atmospherics/pipe/smart/manifold4w/cyan/visible,
/obj/effect/turf_decal/stripes/line{
	dir = 8
	},
/obj/structure/cable,
/turf/open/floor/engine,
/area/ruin/interdyne_planetary_base/science)
"rT" = (
/obj/effect/turf_decal/stripes/line,
/obj/structure/cable,
/obj/machinery/power/emitter/welded{
	dir = 1
	},
/turf/open/floor/engine,
/area/ruin/interdyne_planetary_base/science)
"sa" = (
/obj/machinery/atmospherics/pipe/smart/manifold4w/scrubbers/visible,
/turf/closed/wall/mineral/plastitanium/nodiagonal,
/area/ruin/interdyne_planetary_base/science)
"sY" = (
/obj/machinery/atmospherics/components/trinary/filter/on{
	dir = 1;
	filter_type = list(/datum/gas/nitrogen)
	},
/obj/structure/window/reinforced/plasma/spawner/directional/south,
/turf/open/floor/engine,
/area/ruin/interdyne_planetary_base/science)
"uG" = (
/obj/item/storage/toolbox/syndicate,
/obj/item/pipe_dispenser,
/obj/item/rpd_upgrade/unwrench,
/obj/structure/rack,
/turf/open/floor/iron/dark,
/area/ruin/interdyne_planetary_base/science)
"uT" = (
/obj/machinery/atmospherics/components/unary/portables_connector/visible{
	dir = 4
	},
/obj/machinery/portable_atmospherics/canister/nitrogen,
/turf/open/floor/iron/dark,
/area/ruin/interdyne_planetary_base/science)
"xI" = (
/obj/machinery/atmospherics/pipe/smart/manifold4w/supply/hidden/layer4,
/turf/open/floor/iron/dark,
/area/ruin/interdyne_planetary_base/science)
"xT" = (
/obj/effect/turf_decal/stripes/line{
	dir = 10
	},
/obj/structure/cable,
/turf/open/floor/engine,
/area/ruin/interdyne_planetary_base/science)
"yU" = (
/obj/structure/extinguisher_cabinet/directional/east,
/obj/structure/cable,
/obj/machinery/atmospherics/pipe/smart/manifold4w/supply/hidden/layer4,
/obj/machinery/atmospherics/pipe/smart/manifold4w/scrubbers/hidden/layer2,
/obj/machinery/light/small/directional/east,
/turf/open/floor/iron/dark,
/area/ruin/interdyne_planetary_base/science)
"Au" = (
/obj/machinery/atmospherics/components/unary/portables_connector/visible{
	dir = 4
	},
/obj/machinery/portable_atmospherics/canister/nitrogen,
/obj/machinery/light/directional/west,
/turf/open/floor/iron/dark,
/area/ruin/interdyne_planetary_base/science)
"AS" = (
/obj/machinery/atmospherics/pipe/smart/manifold4w/scrubbers/visible,
/turf/open/floor/engine,
/area/ruin/interdyne_planetary_base/science)
"Ch" = (
/obj/machinery/power/supermatter_crystal/shard/syndicate,
/obj/structure/window/reinforced/plasma/spawner/directional/south,
/turf/open/floor/engine,
/area/ruin/interdyne_planetary_base/science)
"EC" = (
/obj/machinery/door/poddoor{
	id = "lavalandsyndi_mistake"
	},
/obj/effect/spawner/structure/window/reinforced/plasma/plastitanium,
/turf/open/floor/plating,
/area/ruin/interdyne_planetary_base/science)
"HC" = (
/obj/machinery/atmospherics/pipe/smart/manifold4w/supply/hidden/layer4,
/obj/machinery/airalarm/directional/south,
/obj/effect/mapping_helpers/airalarm/syndicate_access,
/turf/open/floor/iron/dark,
/area/ruin/interdyne_planetary_base/science)
"It" = (
/obj/machinery/atmospherics/pipe/smart/manifold4w/cyan/visible,
/turf/closed/wall/mineral/plastitanium/nodiagonal,
/area/ruin/interdyne_planetary_base/science)
"IG" = (
/obj/effect/spawner/structure/window/reinforced/plasma/plastitanium,
/obj/structure/cable,
/turf/open/floor/plating,
/area/ruin/interdyne_planetary_base/science)
"Lc" = (
/obj/machinery/atmospherics/components/binary/pump{
	dir = 4
	},
/turf/open/floor/iron/dark,
/area/ruin/interdyne_planetary_base/science)
"Ni" = (
/obj/machinery/atmospherics/components/unary/passive_vent,
/obj/structure/lattice/catwalk,
/turf/open/misc/asteroid/basalt/lava_land_surface,
/area/ruin/interdyne_planetary_base/science)
"OO" = (
/obj/structure/window/reinforced/plasma/spawner/directional/south,
/obj/structure/window/reinforced/plasma/spawner/directional/east,
/obj/machinery/atmospherics/components/unary/vent_scrubber/on{
	dir = 1
	},
/turf/open/floor/engine,
/area/ruin/interdyne_planetary_base/science)
"Qz" = (
/obj/machinery/atmospherics/components/unary/vent_pump/on/layer4{
	dir = 4
	},
/obj/machinery/light/small/directional/south,
/turf/open/floor/iron/dark,
/area/ruin/interdyne_planetary_base/science)
"Rn" = (
/obj/structure/cable,
/turf/open/floor/engine,
/area/ruin/interdyne_planetary_base/science)
"Rp" = (
/obj/effect/turf_decal/stripes/line{
	dir = 4
	},
/turf/open/floor/engine,
/area/ruin/interdyne_planetary_base/science)
"Vo" = (
/obj/machinery/atmospherics/pipe/smart/manifold4w/cyan/visible,
/obj/machinery/atmospherics/pipe/bridge_pipe/scrubbers/visible{
	dir = 4
	},
/turf/open/floor/engine,
/area/ruin/interdyne_planetary_base/science)
"Vp" = (
/obj/structure/cable,
/obj/machinery/atmospherics/components/unary/vent_scrubber/on/layer2,
/turf/open/floor/iron/dark,
/area/ruin/interdyne_planetary_base/science)
"XN" = (
/obj/machinery/atmospherics/components/tank/nitrogen,
/obj/effect/turf_decal/stripes/line{
	dir = 6
	},
/turf/open/floor/iron/dark,
/area/ruin/interdyne_planetary_base/science)
"XS" = (
/obj/machinery/atmospherics/components/unary/thermomachine/freezer/on{
	dir = 1
	},
/turf/open/floor/engine,
/area/ruin/interdyne_planetary_base/science)
"Yj" = (
/obj/machinery/atmospherics/pipe/smart/manifold4w/cyan/visible,
/obj/effect/turf_decal/stripes/line{
	dir = 8
	},
/turf/open/floor/engine,
/area/ruin/interdyne_planetary_base/science)
"Ys" = (
/obj/effect/turf_decal/stripes/line{
	dir = 8
	},
/obj/structure/cable,
/turf/open/floor/engine,
/area/ruin/interdyne_planetary_base/science)
"ZR" = (
/obj/machinery/atmospherics/pipe/smart/manifold4w/cyan/visible,
/obj/machinery/firealarm/directional/east,
/turf/open/floor/engine,
/area/ruin/interdyne_planetary_base/science)

(1,1,1) = {"
aA
aA
aA
aA
aA
aA
aA
aA
em
em
aA
aA
aA
"}
(2,1,1) = {"
aA
aA
em
em
em
em
em
em
em
eZ
gJ
aA
aA
"}
(3,1,1) = {"
aA
em
em
uT
Au
dO
XN
uG
em
kE
Qz
aA
aA
"}
(4,1,1) = {"
em
em
gX
Lc
Lc
hJ
kE
kE
eq
kE
HC
aA
aA
"}
(5,1,1) = {"
em
bs
Yj
qY
qY
qY
Ys
xT
em
kE
xI
aA
aA
"}
(6,1,1) = {"
hK
me
XS
fY
kw
iF
js
kP
IG
kE
xI
be
aA
"}
(7,1,1) = {"
EC
me
XS
Rn
js
Ch
js
rT
IG
Vp
ef
yU
on
"}
(8,1,1) = {"
em
me
AS
oo
sY
OO
Rp
lR
em
ol
kE
aA
aA
"}
(9,1,1) = {"
em
It
Vo
ZR
iQ
em
aA
aA
aA
aA
aA
aA
aA
"}
(10,1,1) = {"
Ni
sa
sa
em
em
em
aA
aA
aA
aA
aA
aA
aA
"}
