//MAP CONVERTED BY dmm2tgm.py THIS HEADER COMMENT PREVENTS RECONVERSION, DO NOT REMOVE
"ax" = (
/obj/structure/railing/corner,
/obj/structure/flora/grass/jungle/b/style_random,
/turf/open/misc/grass/jungle/planet,
/area/omega/surface/outdoors/nospawn)
"aT" = (
/obj/structure/railing/corner/end/flip{
	dir = 8
	},
/turf/closed/mineral/random/forest,
/area/omega/surface/outdoors/nospawn)
"bE" = (
/obj/structure/flora/rock/pile,
/turf/open/misc/grass/jungle/planet,
/area/omega/surface/outdoors/nospawn)
"cO" = (
/obj/structure/fence/door/opened{
	dir = 1
	},
/turf/open/misc/grass/jungle/planet,
/area/omega/surface/outdoors/nospawn)
"ds" = (
/obj/structure/fence{
	dir = 4
	},
/obj/structure/flora/rock/pile/icy,
/turf/open/misc/grass/jungle/planet,
/area/omega/surface/outdoors/nospawn)
"eu" = (
/obj/structure/flora/rock/pile/style_random,
/turf/open/misc/grass/jungle/planet,
/area/omega/surface/outdoors/nospawn)
"eB" = (
/obj/structure/railing/corner/end{
	dir = 4
	},
/turf/open/misc/grass/jungle/planet,
/area/omega/surface/outdoors/nospawn)
"eE" = (
/obj/structure/railing{
	dir = 6
	},
/obj/structure/flora/rock/pile/style_random,
/turf/open/misc/grass/jungle/planet,
/area/omega/surface/outdoors/nospawn)
"fl" = (
/turf/template_noop,
/area/template_noop)
"fK" = (
/obj/structure/railing,
/obj/structure/flora/rock/style_random,
/turf/open/misc/grass/jungle/planet,
/area/omega/surface/outdoors/nospawn)
"gv" = (
/obj/structure/railing{
	dir = 5
	},
/obj/structure/ladder,
/turf/open/misc/grass/jungle/planet,
/area/omega/surface/outdoors/nospawn)
"hM" = (
/obj/effect/turf_decal/stripes/line{
	dir = 8
	},
/turf/open/floor/stone,
/area/omega/surface/outdoors/nospawn)
"hS" = (
/obj/structure/fence{
	dir = 4
	},
/obj/structure/flora/grass/jungle/b/style_random,
/turf/open/misc/grass/jungle/planet,
/area/omega/surface/outdoors/nospawn)
"jQ" = (
/obj/structure/fence/door,
/turf/open/misc/grass/jungle/planet,
/area/omega/surface/outdoors/nospawn)
"kd" = (
/obj/structure/flora/grass/jungle/b/style_random,
/turf/open/misc/grass/jungle/planet,
/area/omega/surface/outdoors/nospawn)
"kq" = (
/obj/effect/turf_decal/stripes/line{
	dir = 4
	},
/turf/open/floor/stone,
/area/omega/surface/outdoors/nospawn)
"lo" = (
/obj/structure/fence/corner{
	dir = 9
	},
/turf/open/misc/grass/jungle/planet,
/area/omega/surface/outdoors/nospawn)
"lH" = (
/turf/closed/mineral/random/snow,
/area/omega/surface/outdoors/nospawn)
"lR" = (
/obj/structure/railing{
	dir = 8
	},
/turf/open/misc/grass/jungle/planet,
/area/omega/surface/outdoors/nospawn)
"mP" = (
/turf/open/openspace/icemoon/ruins,
/area/omega/surface/outdoors/nospawn)
"op" = (
/obj/structure/fence{
	dir = 4
	},
/obj/structure/sign/warning/secure_area,
/turf/open/misc/grass/jungle/planet,
/area/omega/surface/outdoors/nospawn)
"tW" = (
/obj/structure/fence{
	dir = 4
	},
/obj/structure/flora/rock/pile/icy/style_2,
/obj/structure/sign/warning/secure_area,
/turf/open/misc/grass/jungle/planet,
/area/omega/surface/outdoors/nospawn)
"uy" = (
/obj/effect/mob_spawn/corpse/human/minesite/overseer,
/turf/open/misc/grass/jungle/planet,
/area/omega/surface/outdoors/nospawn)
"vJ" = (
/turf/open/floor/stone,
/area/omega/surface/outdoors/nospawn)
"wg" = (
/obj/structure/fence/cut/medium{
	dir = 4
	},
/turf/open/misc/grass/jungle/planet,
/area/omega/surface/outdoors/nospawn)
"yy" = (
/obj/structure/railing/corner/end/flip{
	dir = 8
	},
/obj/effect/turf_decal/stripes/corner{
	dir = 4
	},
/turf/open/floor/stone,
/area/omega/surface/outdoors/nospawn)
"Aq" = (
/obj/structure/flora/rock/style_random,
/turf/open/misc/grass/jungle/planet,
/area/omega/surface/outdoors/nospawn)
"Dd" = (
/turf/closed/mineral/random/forest,
/area/omega/surface/outdoors/nospawn)
"DG" = (
/obj/structure/flora/tree/jungle/style_random,
/turf/open/misc/grass/jungle/planet,
/area/omega/surface/outdoors/nospawn)
"Ep" = (
/obj/structure/fence/cut/medium{
	dir = 4
	},
/obj/structure/flora/grass/jungle/b/style_random,
/turf/open/misc/grass/jungle/planet,
/area/omega/surface/outdoors/nospawn)
"Ff" = (
/obj/effect/turf_decal/stripes/corner{
	dir = 8
	},
/turf/open/floor/stone,
/area/omega/surface/outdoors/nospawn)
"Fn" = (
/obj/structure/railing{
	dir = 6
	},
/turf/open/misc/grass/jungle/planet,
/area/omega/surface/outdoors/nospawn)
"HU" = (
/obj/structure/railing/corner/end{
	dir = 4
	},
/obj/effect/turf_decal/stripes/corner{
	dir = 1
	},
/turf/open/floor/stone,
/area/omega/surface/outdoors/nospawn)
"Ia" = (
/obj/structure/railing/corner/end{
	dir = 1
	},
/obj/structure/railing/corner/end/flip,
/obj/structure/flora/rock/pile/style_random,
/turf/open/misc/grass/jungle/planet,
/area/omega/surface/outdoors/nospawn)
"IA" = (
/obj/item/flashlight/glowstick/red{
	start_on = 1
	},
/obj/structure/flora/grass/jungle/b/style_random,
/turf/open/misc/grass/jungle/planet,
/area/omega/surface/outdoors/nospawn)
"KT" = (
/obj/structure/railing{
	dir = 6
	},
/obj/structure/table,
/obj/item/binoculars{
	pixel_x = -3;
	pixel_y = 5
	},
/obj/item/flashlight/lantern{
	pixel_x = 6;
	pixel_y = 7
	},
/turf/open/misc/grass/jungle/planet,
/area/omega/surface/outdoors/nospawn)
"Mp" = (
/obj/effect/turf_decal/stripes/line{
	dir = 1
	},
/turf/open/floor/stone,
/area/omega/surface/outdoors/nospawn)
"Oe" = (
/turf/open/misc/grass/jungle/planet,
/area/omega/surface/outdoors/nospawn)
"Ot" = (
/obj/structure/railing/corner,
/turf/open/misc/grass/jungle/planet,
/area/omega/surface/outdoors/nospawn)
"Qi" = (
/obj/effect/turf_decal/stripes/corner,
/obj/item/flashlight/glowstick/red{
	start_on = 1
	},
/turf/open/floor/stone,
/area/omega/surface/outdoors/nospawn)
"Sc" = (
/obj/structure/fence{
	dir = 4
	},
/turf/open/misc/grass/jungle/planet,
/area/omega/surface/outdoors/nospawn)
"Tt" = (
/obj/structure/flora/rock/pile/icy/style_2,
/turf/open/misc/grass/jungle/planet,
/area/omega/surface/outdoors/nospawn)
"Uz" = (
/obj/structure/flora/rock/pile/icy,
/obj/structure/fence{
	dir = 4
	},
/turf/open/misc/grass/jungle/planet,
/area/omega/surface/outdoors/nospawn)
"UY" = (
/obj/structure/fence/cut/large{
	dir = 4
	},
/obj/structure/flora/rock/pile/style_random,
/turf/open/misc/grass/jungle/planet,
/area/omega/surface/outdoors/nospawn)
"Wg" = (
/obj/structure/railing,
/turf/open/floor/stone,
/area/omega/surface/outdoors/nospawn)
"Wk" = (
/obj/item/flashlight/glowstick/red{
	start_on = 1
	},
/turf/open/floor/stone,
/area/omega/surface/outdoors/nospawn)
"Wr" = (
/obj/structure/fence{
	dir = 4
	},
/obj/structure/sign/nanotrasen,
/turf/open/misc/grass/jungle/planet,
/area/omega/surface/outdoors/nospawn)
"Wt" = (
/obj/effect/turf_decal/stripes/line,
/turf/open/floor/stone,
/area/omega/surface/outdoors/nospawn)
"Zn" = (
/obj/structure/fence/cut/large,
/turf/open/misc/grass/jungle/planet,
/area/omega/surface/outdoors/nospawn)

(1,1,1) = {"
fl
fl
fl
fl
fl
fl
fl
fl
fl
fl
fl
fl
fl
fl
fl
fl
fl
fl
fl
fl
fl
fl
fl
fl
fl
fl
fl
"}
(2,1,1) = {"
fl
kd
kd
eu
DG
Dd
Dd
fl
fl
fl
fl
fl
fl
fl
fl
fl
fl
fl
fl
fl
fl
fl
fl
fl
fl
fl
fl
"}
(3,1,1) = {"
IA
Oe
lo
Zn
Dd
Dd
Dd
Dd
mP
mP
mP
mP
mP
mP
mP
mP
mP
mP
mP
fl
fl
fl
fl
fl
fl
fl
fl
"}
(4,1,1) = {"
Oe
eu
jQ
Oe
vJ
Dd
mP
mP
mP
mP
mP
mP
mP
mP
mP
mP
mP
mP
mP
mP
fl
fl
fl
fl
fl
fl
fl
"}
(5,1,1) = {"
fl
kd
Wr
Oe
vJ
kd
kd
mP
mP
mP
mP
mP
mP
mP
mP
mP
mP
mP
mP
mP
mP
fl
fl
fl
fl
fl
fl
"}
(6,1,1) = {"
fl
kd
Dd
eu
Oe
Oe
Oe
eu
mP
mP
mP
mP
mP
mP
mP
mP
mP
mP
mP
mP
mP
mP
fl
fl
fl
fl
fl
"}
(7,1,1) = {"
fl
Dd
Dd
Oe
Oe
Oe
Oe
Oe
lR
mP
mP
mP
mP
mP
mP
mP
mP
mP
mP
mP
mP
mP
mP
fl
fl
fl
fl
"}
(8,1,1) = {"
Dd
Dd
lH
DG
kd
Oe
uy
Ot
KT
mP
mP
mP
mP
mP
mP
mP
mP
mP
mP
mP
mP
mP
mP
mP
fl
fl
fl
"}
(9,1,1) = {"
Dd
Dd
mP
mP
mP
gv
Ia
Fn
mP
mP
mP
mP
mP
mP
mP
mP
mP
mP
mP
mP
mP
mP
mP
mP
mP
fl
fl
"}
(10,1,1) = {"
fl
Dd
mP
mP
mP
mP
mP
mP
mP
mP
mP
mP
mP
mP
mP
mP
mP
mP
mP
mP
mP
mP
mP
mP
mP
fl
fl
"}
(11,1,1) = {"
fl
fl
mP
mP
mP
mP
mP
mP
mP
mP
mP
mP
mP
mP
mP
mP
mP
mP
mP
mP
mP
mP
mP
mP
mP
fl
fl
"}
(12,1,1) = {"
fl
fl
mP
mP
mP
mP
mP
mP
mP
mP
mP
mP
mP
mP
mP
mP
mP
mP
mP
mP
mP
mP
mP
mP
mP
Dd
Dd
"}
(13,1,1) = {"
fl
fl
mP
mP
mP
mP
mP
mP
mP
mP
mP
mP
mP
mP
mP
mP
mP
mP
mP
mP
mP
mP
mP
mP
mP
Dd
Dd
"}
(14,1,1) = {"
fl
fl
Dd
mP
mP
mP
mP
mP
mP
mP
mP
mP
mP
mP
mP
mP
mP
mP
mP
mP
mP
mP
mP
mP
eu
Dd
hS
"}
(15,1,1) = {"
fl
Dd
Dd
Dd
mP
mP
mP
mP
mP
mP
mP
mP
mP
mP
mP
mP
mP
mP
mP
mP
mP
mP
mP
kd
kd
Oe
wg
"}
(16,1,1) = {"
Dd
Dd
kd
kd
Oe
mP
mP
mP
mP
mP
mP
mP
mP
mP
mP
mP
mP
mP
mP
mP
mP
mP
mP
Wk
vJ
Oe
hS
"}
(17,1,1) = {"
Ep
Oe
kd
Oe
Oe
eB
mP
mP
mP
mP
mP
mP
mP
mP
mP
mP
mP
mP
mP
mP
mP
mP
mP
kd
vJ
Oe
UY
"}
(18,1,1) = {"
ds
Oe
DG
Tt
Oe
fK
mP
mP
mP
mP
mP
mP
mP
mP
mP
mP
mP
mP
mP
mP
mP
mP
mP
Aq
Oe
Oe
Sc
"}
(19,1,1) = {"
Uz
Oe
Oe
Oe
vJ
Wg
mP
mP
mP
mP
mP
mP
mP
mP
mP
mP
mP
mP
mP
mP
mP
mP
mP
mP
bE
DG
op
"}
(20,1,1) = {"
cO
Oe
Oe
Qi
kq
yy
mP
mP
mP
mP
mP
mP
mP
mP
mP
mP
mP
mP
mP
mP
mP
mP
mP
mP
mP
kd
wg
"}
(21,1,1) = {"
tW
kd
Oe
Wt
mP
Mp
mP
mP
mP
mP
mP
mP
mP
mP
mP
mP
mP
mP
mP
mP
mP
mP
mP
mP
mP
Dd
Dd
"}
(22,1,1) = {"
hS
Oe
Aq
Ff
hM
HU
mP
mP
mP
mP
mP
mP
mP
mP
mP
mP
mP
mP
mP
mP
mP
mP
mP
mP
mP
Dd
fl
"}
(23,1,1) = {"
Dd
Dd
Dd
kd
ax
eE
mP
mP
mP
mP
mP
mP
mP
mP
mP
mP
mP
mP
mP
mP
mP
mP
mP
mP
mP
fl
fl
"}
(24,1,1) = {"
fl
Dd
Dd
Dd
aT
mP
mP
mP
mP
mP
mP
mP
mP
mP
mP
mP
mP
mP
mP
mP
mP
mP
mP
mP
fl
fl
fl
"}
(25,1,1) = {"
fl
fl
Dd
Dd
mP
mP
mP
mP
mP
mP
mP
mP
mP
mP
mP
mP
mP
mP
mP
mP
mP
mP
mP
fl
fl
fl
fl
"}
(26,1,1) = {"
fl
fl
fl
Dd
mP
mP
mP
mP
mP
mP
mP
mP
mP
mP
mP
mP
mP
mP
mP
mP
mP
mP
fl
fl
fl
fl
fl
"}
(27,1,1) = {"
fl
fl
fl
fl
fl
fl
mP
mP
mP
mP
mP
mP
mP
mP
mP
mP
mP
mP
mP
mP
mP
fl
fl
fl
fl
fl
fl
"}
(28,1,1) = {"
fl
fl
fl
fl
fl
fl
fl
mP
mP
mP
mP
mP
mP
mP
mP
mP
mP
mP
mP
mP
fl
fl
fl
fl
fl
fl
fl
"}
(29,1,1) = {"
fl
fl
fl
fl
fl
fl
fl
fl
mP
mP
mP
mP
mP
mP
mP
mP
mP
mP
mP
fl
fl
fl
fl
fl
fl
fl
fl
"}
(30,1,1) = {"
fl
fl
fl
fl
fl
fl
fl
fl
fl
fl
fl
fl
fl
fl
fl
fl
fl
fl
fl
fl
fl
fl
fl
fl
fl
fl
fl
"}
(31,1,1) = {"
fl
fl
fl
fl
fl
fl
fl
fl
fl
fl
fl
fl
fl
fl
fl
fl
fl
fl
fl
fl
fl
fl
fl
fl
fl
fl
fl
"}
